Q d d d d d d d d d d d d d d d d d E
r s m m m m m v v v m m m m m m s l 
r s t t t t t e e e t t t t t t s l
r s t t t t t x x x t t t t t t s l   
r m t t m m m m m m m m m m t t m l
r m y y m m m m m m m m m m y y m l
r m n n m m m m m m m m m m n n m l 
r m t t m m m m m m m m m m t t m l
r m t t m m m m m m m m m m t t m l
r m t t m m m m m m m m m m t t m l
r m t t m m m m m m m m m m t t m l
r m t t m m m m m m m m m m t t m l
r m t t m m m m m m m m m m t t m l
r m t t m m m m m m m m m m t t m l
r m t t m m m m m m m m m m t t m l
r m t t m m m m m m m m m m t t m l
B b p p b b b b b b b b b b p p b B 
A a p p a a a a a a a a a a p p a A
r m t t m m m m m m m m m m t t m l 
r m t t m m m m m m m m m m t t m l
r m t t m m m m m m m m m m t t m l   
r m t t m m m m m m m m m m t t m l
r m t t m m m m m m m m m m t t m l
r m t t m m m m m m m m m m t t m l 
r m t t m m m m m m m m m m t t m l
r m t t m m m m m m m m m m t t m l
r m t t m m m m m m m m m m t t m l
r m n n m m m m m m m m m m n n m l
r m y y m m m m m m m m m m y y m l
r m t t m m m m m m m m m m t t m l 
r s t t t t t e e e t t t t t t s l
r s t t t t t x x x t t t t t t s l
r s m m m m m v v v m m m m m m s l
Z u u u u u u u u u u u u u u u u C